111111111111111111
1P0100000000001001
100000000000010001
100000000000000001
100000000000000001
10C00C000000000001
100001000C000C0001
10001101000M0001E1
111111111111111111