11111111111111111111111111111111111111111111111111111111111111
1C0000C100C000M0000C000M000C0000000000000C000C10000000000000E1
100M000101111111111111111111100M000000000100001C000000000M0011
11111001011000000000000000001111111100000000001000000011111111
1C00M000C10000000000111C0000P000000010000M0000100M000000000001
11111111110000000000001111000000000000011111011111111000000001
100C000C01000000000M000000110110001000C1C0C1C110000C0000000001
1C00000001C000000011100011100010010100C1C0C1C100C00000M00000C1
11000000C11000C011100000000C0C00100010C1C0C1000011111111111111
1000000011000010000000000111111000000C1000111111C00000000000C1
10000M00M00000000000000001000M0000C00CC1000000C1C0000000000M01
11111111111001100C000C001000111100M0001C00M00001C00000C1001111
1C00000000001CC10000M0000001100011111101111110001C0M0C1C000001
100M00000001000111111111111C00C0000C0000000000M001111111100001
1111111000100000000000M000C100M0001100000000C11100M00000000001
1CCCCCC000000000000011111000111111001111000C1111111111100000C1
1000M000M000M000M00000M0000C000M0000C00M00C111C00M0000M00000C1
11111111111111111111111111111111111111111111111111111111111111